PISTOL
0 0 0 0 0 0 0 0 0 0
0 0 0 0 0 0 0 0 15 0
0 7 7 12 7 7 7 15 15 15
8 7 4 7 7 7 7 7 7 15
0 8 7 15 0 7 3 3 3 0
0 8 7 7 7 0 0 0 0 0
0 8 7 0 0 0 0 0 0 0
0 8 8 8 0 0 0 0 0 0
0 0 0 0 0 0 0 0 0 0
0 0 0 0 0 0 0 0 0 0
AMMO:
6
ACCURACY:
10
DAMAGE:
0 10
BPR:
1

MEDIKIT
0 0 0 12 12 12 12 0 0 0
0 0 0 12 4 4 1 0 0 0
0 0 0 12 4 4 1 0 0 0
12 12 12 12 4 4 4 12 12 12
12 4 4 4 4 4 4 4 4 4
12 4 4 4 4 4 4 4 4 4
12 1 1 1 4 4 4 4 4 4
0 0 0 12 4 4 4 0 0 0
0 0 0 12 4 4 4 0 0 0
0 0 0 12 4 4 4 0 0 0
AMMO:
10
ACCURACY:
0
DAMAGE:
20 30
BPR:
1

AKM
0 0 0 0 0 0 0 0 0 0
0 0 0 0 0 0 0 0 8 0
0 0 0 0 0 0 0 0 7 0
0 8 8 8 7 7 7 7 7 7
7 7 7 7 8 8 8 0 0 0
8 7 8 7 0 0 0 0 0 0
7 0 8 7 0 0 0 0 0 0
0 0 0 8 7 0 0 0 0 0
0 0 0 0 0 0 0 0 0 0
0 0 0 0 0 0 0 0 0 0
AMMO:
30
ACCURACY:
15
DAMAGE:
0 40
BPR:
5

DETECTOR
0 0 7 7 0 0 0 0 0 0
0 7 8 7 7 0 0 0 0 0
0 7 8 7 7 0 9 0 2 0
7 8 8 8 7 7 7 7 7 0
7 1 1 8 7 7 7 2 7 0
7 1 1 8 7 7 7 7 7 0
7 8 8 8 7 7 7 9 7 0
0 7 8 7 7 7 7 9 7 0
0 7 8 7 7 0 7 7 7 0
0 0 7 7 0 0 0 0 0 0
AMMO:
1
ACCURACY:
0
DAMAGE:
0 0
BPR:
0

LANDMINE
0 0 7 0 0 0 0 7 0 0
0 0 7 0 0 0 0 7 0 0
0 0 0 7 0 0 7 0 0 0
0 0 0 0 7 7 0 0 0 0
0 0 7 7 7 8 8 8 0 0
0 7 10 10 7 8 2 2 8 0
0 7 7 7 7 8 8 8 8 0
0 7 10 10 10 2 2 2 8 0
0 7 10 10 10 2 2 2 8 0
0 0 8 8 8 8 8 8 0 0
AMMO:
1
ACCURACY:
0
DAMAGE:
500 500
BPR:
1

SNIPER
0 0 0 0 0 0 0 0 0 0
0 0 7 7 7 7 7 0 0 0
0 0 0 7 0 7 0 0 0 0
7 7 7 7 7 7 7 7 7 7
7 8 7 7 8 8 8 0 0 0
0 0 7 0 0 0 0 0 0 0
0 0 0 0 0 0 0 0 0 0
0 0 0 0 0 0 0 0 0 0
0 0 0 0 0 0 0 0 0 0
0 0 0 0 0 0 0 0 0 0
AMMO:
8
ACCURACY:
2
DAMAGE:
40 100
BPR:
1

MASHINEGUN
0 0 0 0 0 0 0 0 0 0
0 7 7 7 7 0 0 0 0 0
7 7 2 2 2 7 7 7 7 7
0 7 7 7 7 7 8 8 8 8
0 7 8 8 7 0 0 0 0 0
0 7 7 7 0 0 0 0 0 0
0 7 8 7 0 0 7 7 7 0
7 8 7 0 0 7 8 7 8 7
7 8 7 0 7 8 7 0 7 8
0 7 7 7 7 7 0 0 0 7
AMMO:
300
ACCURACY:
30
DAMAGE:
0 50
BPR:
30

PLAZMA
0 0 0 0 0 0 2 0 0 0
0 7 7 7 7 0 7 7 7 0
7 9 9 2 7 7 7 9 2 7
0 7 7 7 7 8 7 7 7 7
7 7 0 7 7 0 0 0 0 0
7 0 0 2 7 0 0 0 0 0
7 0 0 9 7 0 0 0 0 0
0 0 0 7 7 0 0 0 0 0
0 0 0 0 0 0 0 0 0 0
0 0 0 0 0 0 0 0 0 0
AMMO:
5
ACCURACY:
20
DAMAGE:
100 500
BPR:
1

HAMMER
0 0 0 0 9 8 0 0 0 0
0 0 7 7 7 7 7 7 0 0
0 7 7 4 7 7 4 7 8 0
0 7 7 7 4 4 7 8 8 0
0 7 7 4 7 7 4 8 8 0
0 0 8 8 8 8 8 8 0 0
0 0 0 0 9 8 0 0 0 0
0 0 0 0 9 8 0 0 0 0
0 0 0 0 9 8 0 0 0 0
0 0 0 0 9 8 0 0 0 0
AMMO:
1
ACCURACY:
100
DAMAGE:
300 500
BPR:
1

ROCKET
0 0 0 0  13 0 0 0 0 0
0 0 0 4  4 13 0 0 0 0
0 0 0 4  4 13 0 0 0 0
0 0 0 4  14 13  0 0 0 0
0 0 0 8  8 8  0 0 0 0
0 0 0 14 8 14 0 0 0 0
0 0 0 4  4 13 0 0 0 0
0 0 0 4  4 13 0 0 0 0
0 0 0 4  4 13 0 0 0 0
0 0 4 0  4 0 13 0 0 0
AMMO:
1
ACCURACY:
0
DAMAGE:
800 1000
BPR:
1

