-1 -1 11 11 -1 -1 -1 -1 -1 -1
-1 11 11 11 11 -1 -1 -1 -1 -1
-1 11 11 11 11 -1 -1 -1 -1 -1
-1 11 0 0 11 -1 -1 -1 -1 -1
-1 0 7 0 0 -1 -1 -1 -1 -1
-1 0 0 0 0 -1 -1 -1 -1 -1
-1 11 0 0 11 -1 -1 -1 -1 -1
-1 11 11 11 11 -1 0 8 8 8
-1 11 11 11 11 11 0 0 0 0
-1 -1 11 11 11 11 11 12 -1 -1