###############
#`````#```````#
#`#`#``#`####`#
#`#`##`````#``#
#`````#`##```##
#####`#``#`####
#`#```#`#`````#
#```#```#`###`#
#`#`#####```#`#
#`#`````#####`#
#`##``#```````#
#`#``#``##`##`#
#```#####```#`#
#`#``#````#`#`#
###############