0  0  10 10 10 10 10 4  0  0
0  10 2 0  0  0  2 4  0  0
0  10 2 0  0  0  0  0  0  0
10 10 2 0  10 10 10 10 10 4
2 10 10 2 2 10 10 10 10 10
2 10 2 0  2 2 2 2 2 4
0  10 2 0  0  0  0  0  0  0
0  2 2 0  0  0  10 4  0  0
0  0  10 10 10 10 10 0  0  0
0  0  0  0  0  0  2 4  0  0